m m m m m m m m 0 0 m m m m m m m m m m m 0 0 m m m m m m m m m 
m 0 0 0 0 0 0 0 0 0 0 0 0 0 0 0 0 0 0 0 0 0 0 0 0 0 0 0 0 0 0 m 
m 0 0 0 0 0 0 0 0 0 0 0 0 0 0 0 0 0 0 0 0 0 0 0 0 0 0 0 0 0 0 m 
m 0 0 0 0 0 0 0 0 0 0 0 0 0 0 0 0 0 0 0 0 0 0 0 0 0 0 0 0 0 0 m 
m 0 0 0 0 0 0 0 0 0 0 0 0 0 0 0 0 0 0 2 0 0 0 0 0 0 0 0 0 0 0 m 
m 0 0 0 0 0 0 0 0 0 0 0 0 0 0 0 0 0 0 2 3 0 0 0 0 2 0 0 0 0 0 m 
m 0 0 0 0 0 0 0 0 0 0 0 0 0 0 0 0 0 0 2 3 0 0 0 3 0 0 0 0 0 0 m 
m 0 0 0 0 0 0 0 0 0 0 0 0 0 0 0 0 0 0 0 0 0 0 6 0 2 0 0 0 0 0 m 
0 0 0 0 0 0 0 0 0 0 0 0 0 0 0 0 0 0 0 0 0 0 0 0 0 0 0 0 0 0 0 0 
0 0 0 0 0 0 0 0 0 0 0 0 0 0 0 0 0 0 0 0 0 0 0 0 0 0 0 0 0 0 0 0 
m 0 0 0 0 0 0 0 0 0 0 3 3 0 3 3 3 3 2 0 0 0 0 2 0 0 0 0 0 0 0 m 
m 0 0 0 0 0 0 0 0 0 0 6 6 2 3 6 6 6 2 0 0 0 0 0 0 0 0 0 0 0 0 m 
m 0 0 0 0 0 0 0 0 0 3 6 c 0 3 6 c 6 0 0 0 0 0 0 0 0 0 0 0 0 0 m 
m 0 0 0 0 0 0 0 0 0 3 6 6 6 3 6 6 6 3 0 0 0 0 0 0 0 0 0 0 0 0 m 
m 0 0 0 0 0 0 0 0 0 0 3 3 3 0 3 0 0 0 0 0 0 0 0 0 0 0 0 0 0 0 m 
m 0 0 0 0 0 0 0 0 0 0 0 2 0 0 0 0 0 0 0 0 0 0 0 0 0 0 0 0 0 0 m 
m 0 0 0 0 0 0 0 0 0 0 0 0 0 0 0 0 0 1 0 0 0 0 0 0 0 0 0 0 0 0 m 
m m m m m m m m 0 0 m m m m m m m m m m m 0 0 m m m m m m m m m 